R   1920 1080
SO ./pics/WALL64.xpm
NO ./pics/WALL11.xpm

WE ./pics/WALL6.xpm
EA ./pics/eagle.xpm

S ./pics/barrel.xpm
F 200,150,12
C 225,30,12


        1111111111111111111111111
        1000000000110000000000001
        1211020001110000002000001
        12012E2000000000000000001
111111111211020001110000000000001
100000000211000001110111111111111 
11110111111111011100000010001
11110111111111011101010010001      11111
11000000110101011100000010001      10001
10002000000000001100000010001      11111
10000000000000001101010010001
1100000111010101111101111000111
11110111 1110101 101111010001
11111111 1111111 111111111111